/action

// 0 空気
// 1 ブロック
// 2 消えるブロック
// 3 透明ブロック
// 4 セーブ
// 5 トラップ
// 6 泳げる
// 7 ワープ

// 横20 縦12
// 左上のマスが初期地点になる

/start
00111111511111111111,
00500050000000500001,
10005000505050005004,
11111111111211111101,
15555555555555555501,
17222222222222222221,
12222222222223222221,
12212222222222221221,
12222222223222222221,
12222222222222322221,
12022223222222222221,
12222222222222221221,
/end
