/action

// 0 空気
// 1 ブロック
// 2 消えるブロック
// 3 透明ブロック
// 4 セーブ
// 5 トラップ
// 6 泳げる
// 7 ワープ

// 横20 縦12
// 左上のマスが初期地点になる

/start
01111111111111111511,
23000000000000000005,
23000000300000300305,
23000000000000000571,
23003000000000000501,
23000000000000000001,
23000030000000000501,
23000000022333333301,
23555555500000000001,
23000000000000000001,
26000000000000000304,
22222222300000000531,
/end
