/action

// 0 空気
// 1 ブロック
// 2 消えるブロック
// 3 透明ブロック
// 4 セーブ
// 5 トラップ
// 6 泳げる
// 7 ワープ

// 横20 縦12
// 左上のマスが初期地点になる

/start
00051111111111115111,
05000000000000000001,
11111510030020030301,
17000010000000000301,
13333010300300000301,
10000015555555555301,
16666615500000000301,
16555515522331332301,
16566650025000000301,
16565620215053113301,
16666630545000000001,
11111111111111111151,
/end
