/action

// 0 空気
// 1 ブロック
// 2 消えるブロック
// 3 透明ブロック
// 4 セーブ
// 5 トラップ
// 6 泳げる
// 7 ワープ

// 横20 縦12
// 左上のマスが初期地点になる

/start
05515105005001155555,
00010005005500050004,
11010111111111010001,
11000100000001000501,
11010123333301111101,
11515100000300000001,
06060501116033353331,
05050554555000000001,
03010001000121122101,
03333000000555555501,
07311003000000000005,
51511111511111111111,
/end
